1111177777
1444177777
14A4177717
1444177717
1111177777
7077777077
77755777AA
7BB77777A7
7777766AA7
7777AAAA77